000000000000000000000000000000000000000000000000000000000000000000000000000000000000000000000000000
011111111111010111011111111111111101111101111111110111111101111111111101111111111111110111110101010
000100010101010001010101000101000100010001010000000000010001000000000000000100010100000001000101010
011111010101011111110101010101010111011101010111011101011111011101111101010111010111111101110111010
000100010100010000000000010000010000010001000100000101010000010000010001010100000000000001000100010
011101010101110101010111010111110101011101111111010111010101110101010111111101011101111101111101110
000101010101010101010100010001000101010001000000010100010101010101010001010101000101000101010001000
010111010101010111011101110111111111111111011111111111110111011111110101010111010111110101011111110
010100000000010100010001010000010000000000000100000000010100010001000101010001010001000001000000000
010101011101010111111111010101110101111101010101011111011101110111010111011101110111111111111111110
010101000101010101000000000101010100010001010101000100000000010100010101000000000001000101000000010
010101011111111101110111011101010111011101011101011101111111110111010101110111010101110101111111010
010101000101000000000100010001010100010001010001010001010000010101010100010001010101000000010000010
010111010101111111111111010111111111110101010111111111011101111101111101010111111111011111011101010
010100010001000000010000010001000000000101010100000000000000000101000101000001000000010000000001000
010101111101011111011111110111111111110111111111111111111101110101011111111111011111111111111101110
010100010001010000000100000100000001000100000100000000000001000000010100010101010000010000000001000
011111111111111111110101110101110111011101110111110111110111110101010111010101111111010111111111110
010100000000000000000001000101000000010001000100000101000001010101000100010000000001000100000000010
010111010111011101011111110101010101111101110101111101110111011111010101011111111101010101111111010
000100010100010101010000000101010101010001000001000000000100000000010001000000000100010100010100000
010111111111010101111111011101010111010101010111010111111111010111011101111111110111111111110111110
010100000000010001000000010001010100000101010001010100010000010001010001000000010000000001000000000
011101010111011111111101111111111111111111010101111111011111111101111111111111010111111101111111110
010101010100010100010101000100010000000101010100010001000000000001000100010000000001010101000000000
010111111101010111010111110101011101110101111111111101011101111111110111011111110111010101110101110
000100000001010000010101010001000101010001010100000000010000010000000100010000000001000000010101000
010101111111111101010101011111110111011101010111111101111111111111110101011111111111111111010111110
010101010101010001010001010000010001000001000000000001000100010000010101000101000101000000000100010
011111010101010111010111011111010101011101110111111111110101011111010111110101110101111101110101010
010000010001010100000100000101010100010000000101000001000001000000000101000000000000000001000101000
010111010111011111011101110101011101111101111101110101010111110111110101111111111111111111111111110
010100010000010100010001000001010000010001000100010101010101000100000001010001000100000101000101000
011111011111010111111111110111011111111111110111010111111101111111110111011101011111110101110101110
000000000000000000000000000000000000000000000000000000000000000000000000000000000000000000000000000
